P,P,P,P,P,P,P,P,P,P,P,P,P,P,P,P,P,P,P,P,P,P,P,P,P,P
P,2,C,C,P,P,P,P,P,P,P,P,P,P,P,P,P,P,P,P,P,P,P,P,P,P
P,C,C,C,C,P,P,P,P,P,P,P,P,P,P,P,P,P,P,P,P,P,P,P,P,P
P,C,I,C,P,P,P,P,P,P,P,P,P,P,P,P,P,P,P,F,C,P,P,P,P,P
P,C,C,C,P,P,P,P,P,P,P,P,P,P,P,P,P,P,P,C,C,P,P,P,P,P
P,C,2,C,C,C,C,C,C,C,C,C,C,C,C,C,C,C,P,C,C,P,P,P,P,P
P,C,C,C,C,C,C,1,C,C,C,C,2,C,C,C,C,C,P,C,C,P,P,P,P,P
P,P,P,P,P,P,P,P,P,P,P,P,P,P,P,P,C,C,P,C,C,P,P,P,P,P
P,P,P,P,P,P,P,P,P,P,P,P,P,P,P,P,C,C,P,2,C,P,P,P,P,P
P,P,P,P,P,P,P,P,P,P,P,P,P,P,P,P,C,C,P,C,C,P,P,P,P,P
P,P,P,P,P,P,P,P,P,P,P,C,C,C,C,C,C,C,P,C,C,P,P,P,P,P
P,P,P,P,P,P,P,P,P,P,P,2,C,C,C,C,C,C,P,C,C,C,C,C,P,P
P,P,P,P,P,P,P,P,P,P,P,C,C,C,P,P,P,P,P,C,C,C,C,C,P,P
P,P,P,P,P,P,P,P,P,P,P,P,C,C,P,P,P,P,P,P,P,P,C,C,P,P
P,P,P,P,P,P,P,P,P,P,P,P,C,C,P,P,P,P,P,P,P,P,C,C,P,P
P,P,P,P,P,P,P,P,P,P,P,P,C,C,P,P,P,P,P,P,P,P,C,C,P,P
P,P,P,P,P,P,P,P,P,P,P,P,C,C,C,C,C,C,C,C,C,C,C,C,P,P
P,P,P,P,P,P,P,P,P,P,P,P,C,C,C,C,C,C,C,C,C,C,C,C,P,P
P,P,P,P,P,P,P,P,P,P,P,P,P,P,P,P,P,P,P,P,P,P,P,P,P,P
