PPPPPPPPPPPPPPPPPPPPPPPPPPPPPPPPPPPPPPPPPPPPPPPPPPFP
PP IPPPPPPPPPPPPPPPPPPPPPPPPPPPPPPPPPPPPPPPPPPPPPP P
P  PPPPPPPPPPPPPPPP3PPPPPPPPPPPPPPPPPPPPPPPPPPPPPP P
PP  PPPPPPPPPPPPPPP PPPPPPPPPPPPPPPPPPPPPPPPPPPPPP P
PPP PPPPPPPPPPPPPPP PPPPPPPPPPPPPPPPPPPPPPPPPPPPPP P
PPP  PPPPPPPPPPPPPP PPPPPPPPPPPPPPPPPPPPPPPPPPPPPP P
PPPP   1                                           P
PPPPPPPPPPPPPPPPPPPPPPPPPPPPPPPPPPPPPPPPPPPPPPPPPPPP
